0 0 0 0 0 0 0 0 0 0 0 0 0 0 0 0
4 0 0 0 0 0 0 0 0 0 0 0 4 0 0 0
4 1 0 0 0 0 0 0 0 0 0 2 4 0 0 0
4 1 2 0 0 0 0 0 0 0 0 2 4 0 0 0
4 1 2 3 0 0 0 0 0 0 3 2 4 0 0 0
4 1 2 3 1 0 0 0 0 1 3 2 4 0 0 0
4 1 2 3 1 6 0 0 6 1 3 2 4 0 0 0
4 1 2 3 1 6 5 5 6 1 3 2 4 0 0 0
4 1 2 3 1 6 5 5 6 1 3 2 4 0 0 0
-1 -1 -1 -1 -1 -1 -1 -1 -1 -1 -1 -1 -1 -1 4 4
0 0 0 0 0 0 0 0 0 0 0 0 0 0 0 0
0 0 0 0 0 0 0 0 0 0 0 0 0 0 0 0
0 0 0 0 0 0 0 0 0 0 0 0 0 0 0 0
0 0 0 0 0 0 0 0 0 0 0 0 0 0 0 0
0 0 0 0 0 0 0 0 0 0 0 0 0 0 0 0
0 0 0 0 0 0 0 0 0 0 0 0 0 0 0 0