6 6 6 6 6 6 6 6 6 6 6 6 6 6 6 6
6 0 0 0 0 0 0 0 0 0 0 0 0 0 0 6
6 0 0 0 0 0 0 0 0 0 0 0 0 0 0 6
6 0 0 5 0 5 0 0 5 0 5 0 0 5 0 5
6 4 4 5 0 5 4 4 5 0 5 4 4 5 0 5
6 3 3 5 0 5 3 3 5 0 5 3 3 5 0 5
6 3 3 5 0 5 3 3 5 0 5 3 3 5 0 5
6 3 3 5 0 5 3 3 5 0 5 3 3 5 0 5
-1 -1 -1 -1 0 -1 -1 -1 -1 0 -1 -1 -1 -1 0 -1
0 0 0 0 0 0 0 0 0 0 0 0 0 0 0 0
0 0 0 0 0 0 0 0 0 0 0 0 0 0 0 0
0 0 0 0 0 0 0 0 0 0 0 0 0 0 0 0
0 0 0 0 0 0 0 0 0 0 0 0 0 0 0 0
0 0 0 0 0 0 0 0 0 0 0 0 0 0 0 0
0 0 0 0 0 0 0 0 0 0 0 0 0 0 0 0
0 0 0 0 0 0 0 0 0 0 0 0 0 0 0 0