0 0 0 0 0 0 0 0 0 0 0 0 0 0 0 0
0 0 0 0 0 0 0 0 0 0 0 0 0 0 0 0
0 0 0 0 0 0 0 0 0 0 0 0 0 0 0 0
2 2 0 0 0 0 0 0 0 0 0 0 0 0 0 0
2 2 3 3 0 0 0 0 0 0 0 0 0 0 6 6
2 2 3 3 5 5 0 0 0 0 0 0 2 2 6 6
2 2 3 3 5 5 6 6 0 0 3 3 2 2 6 6
2 2 3 3 5 5 6 6 1 1 3 3 2 2 6 6
0 0 -1 -1 5 5 6 6 1 1 3 3 2 2 -1 -1
0 0 0 0 5 5 6 6 1 1 3 3 2 2 0 0
0 0 0 0 0 0 -1 -1 1 1 -1 -1 0 0 0 0
0 0 0 0 0 0 0 0 1 1 0 0 0 0 0 0
0 0 0 0 0 0 0 0 0 0 0 0 0 0 0 0
0 0 0 0 0 0 0 0 0 0 0 0 0 0 0 0
0 0 0 0 0 0 0 0 0 0 0 0 0 0 0 0
0 0 0 0 0 0 0 0 0 0 0 0 0 0 0 0