0 0 0 0 0 0 0 0 0 0 0 0 0 0 0 0
6 1 1 6 6 6 6 6 6 6 6 6 6 1 1 6
6 1 3 1 6 6 6 6 6 6 6 6 1 5 1 6
6 1 3 3 1 1 1 1 1 1 1 1 5 5 1 6
6 1 3 3 3 3 3 1 1 5 5 5 5 5 1 6
6 1 3 3 3 3 3 1 1 5 5 5 5 5 1 6
6 6 1 3 3 3 3 1 1 5 5 5 5 1 6 6
6 6 6 1 3 3 3 1 1 5 5 5 1 6 6 6
6 6 6 6 1 3 3 1 1 5 5 1 6 6 6 6
6 6 6 6 6 1 3 1 1 5 1 6 6 6 6 6
6 6 6 6 6 6 1 1 1 1 6 6 6 6 6 6
0 0 0 0 0 0 0 0 0 0 0 0 0 0 0 0
0 0 0 0 0 0 0 0 0 0 0 0 0 0 0 0
0 0 0 0 0 0 0 0 0 0 0 0 0 0 0 0
0 0 0 0 0 0 0 0 0 0 0 0 0 0 0 0
0 0 0 0 0 0 0 0 0 0 0 0 0 0 0 0