0 0 0 0 0 0 0 0 0 0 0 0 0 0 0 0
0 0 0 0 0 0 0 0 0 0 0 0 0 0 0 0
5 3 5 3 5 3 5 0 0 3 5 3 5 3 5 3
3 5 3 5 3 5 3 0 0 5 3 5 3 5 3 5
6 3 6 3 6 3 6 0 0 3 6 3 6 3 6 3
3 6 3 6 3 6 3 0 0 6 3 6 3 6 3 6
4 3 4 3 4 3 4 0 0 3 4 3 4 3 4 3
3 4 3 4 3 4 3 0 0 4 3 4 3 4 3 4
-1 3 -1 3 -1 3 -1 0 0 3 -1 3 -1 3 -1 3
0 0 0 0 0 0 0 0 0 0 0 0 0 0 0 0
0 0 0 0 0 0 0 0 0 0 0 0 0 0 0 0
0 0 0 0 0 0 0 0 0 0 0 0 0 0 0 0
0 0 0 0 0 0 0 0 0 0 0 0 0 0 0 0
0 0 0 0 0 0 0 0 0 0 0 0 0 0 0 0
0 0 0 0 0 0 0 0 0 0 0 0 0 0 0 0
0 0 0 0 0 0 0 0 0 0 0 0 0 0 0 0