0 0 0 0 0 0 0 0 0 0 0 0 0 0 0 0
0 0 0 0 0 0 0 0 0 0 0 0 0 0 0 0
0 0 0 0 0 0 0 0 0 0 0 0 0 0 0 0
0 -1 -1 -1 -1 -1 -1 -1 -1 -1 -1 -1 -1 -1 -1 0
0 -1 4 4 4 4 4 4 4 4 4 4 4 4 -1 0
0 -1 4 6 6 6 6 6 6 6 6 6 6 4 -1 0
0 -1 4 6 1 1 1 1 1 1 1 1 6 4 -1 0
0 -1 4 6 0 0 0 0 0 0 0 0 6 4 -1 0
0 -1 4 6 6 6 6 6 6 6 0 0 0 0 -1 0
0 -1 4 4 4 4 4 4 4 4 4 4 0 0 -1 0
0 -1 -1 -1 -1 -1 -1 -1 -1 -1 -1 -1 -1 0 -1 0
0 0 0 0 0 0 0 0 0 0 0 0 0 0 0 0
0 0 0 0 0 0 0 0 0 0 0 0 0 0 0 0
0 0 0 0 0 0 0 0 0 0 0 0 0 0 0 0
0 0 0 0 0 0 0 0 0 0 0 0 0 0 0 0
0 0 0 0 0 0 0 0 0 0 0 0 0 0 0 0