0 0 0 0 0 0 0 0 0 0 0 0 0 0 0 0
0 0 0 0 0 0 0 0 0 0 0 0 0 0 0 0
0 0 0 0 0 0 0 0 0 0 0 0 0 0 0 0
0 0 0 0 0 0 0 0 0 0 0 0 0 0 0 0
0 -1 1 0 0 4 0 0 3 0 0 6 0 -1 0 0
0 -1 1 0 5 4 6 0 3 1 0 6 2 -1 0 0
0 -1 1 5 0 4 0 6 3 0 1 6 0 -1 0 0
0 -1 1 0 5 4 6 0 3 1 0 6 2 -1 0 0
0 -1 1 5 0 4 0 6 3 0 1 6 0 -1 0 0
0 -1 1 0 5 4 6 0 3 1 0 6 2 -1 0 0
0 -1 1 0 0 4 0 0 3 0 0 6 0 -1 0 0
0 -1 -1 -1 -1 -1 -1 -1 -1 -1 -1 -1 -1 -1 0 0
0 0 0 0 0 0 0 0 0 0 0 0 0 0 0 0
0 0 0 0 0 0 0 0 0 0 0 0 0 0 0 0
0 0 0 0 0 0 0 0 0 0 0 0 0 0 0 0
0 0 0 0 0 0 0 0 0 0 0 0 0 0 0 0