0 0 0 0 0 0 0 0 0 0 0 0 0 0 0 0
0 0 0 0 0 0 0 0 0 0 0 0 0 0 0 0
0 -1 3 3 3 3 3 3 3 3 3 3 3 3 -1 0
0 -1 5 4 4 6 6 3 3 6 6 4 4 5 -1 0
0 -1 5 4 4 6 6 3 3 6 6 4 4 5 -1 0
0 -1 5 4 4 6 6 3 3 6 6 4 4 5 -1 0
0 -1 5 4 4 6 6 3 3 6 6 4 4 5 -1 0
0 -1 5 4 4 6 6 3 3 6 6 4 4 5 -1 0
0 -1 5 4 4 6 6 3 3 6 6 4 4 5 -1 0
0 -1 3 3 3 3 3 3 3 3 3 3 3 3 -1 0
0 0 0 0 0 0 0 0 0 0 0 0 0 0 0 0
0 0 0 0 0 0 0 0 0 0 0 0 0 0 0 0
0 0 0 0 0 0 0 0 0 0 0 0 0 0 0 0
0 0 0 0 0 0 0 0 0 0 0 0 0 0 0 0
0 0 0 0 0 0 0 0 0 0 0 0 0 0 0 0
0 0 0 0 0 0 0 0 0 0 0 0 0 0 0 0