0 0 0 0 0 0 0 0 0 0 0 0 0 0 0 0
4 4 4 4 4 4 4 4 4 4 4 4 4 4 4 4
5 5 5 5 5 5 5 5 5 5 5 5 5 5 5 5
6 6 6 6 6 6 6 6 6 6 6 6 6 6 6 6
3 0 0 0 0 -1 -1 -1 -1 -1 -1 0 0 0 0 3
3 4 4 4 4 -1 0 5 5 0 -1 4 4 4 4 3
3 0 0 0 0 0 0 5 5 0 0 0 0 0 0 3
3 0 0 0 0 0 0 5 5 0 0 0 0 0 0 3
3 0 0 0 3 5 5 5 5 5 5 3 0 0 0 3
3 -1 -1 -1 3 3 3 3 3 3 3 3 -1 -1 -1 3
0 0 0 0 0 0 0 0 0 0 0 0 0 0 0 0
0 0 0 0 0 0 0 0 0 0 0 0 0 0 0 0
0 0 0 0 0 0 0 0 0 0 0 0 0 0 0 0
0 0 0 0 0 0 0 0 0 0 0 0 0 0 0 0
0 0 0 0 0 0 0 0 0 0 0 0 0 0 0 0
0 0 0 0 0 0 0 0 0 0 0 0 0 0 0 0