0 0 0 0 0 0 0 0 0 0 0 0 0 0 0 0
0 0 0 0 0 0 0 0 0 0 0 0 0 0 0 0
0 0 0 0 0 0 0 0 0 0 0 0 0 0 0 0
0 0 0 -1 4 3 2 4 6 1 3 4 -1 0 0 0
0 0 0 -1 4 3 2 4 6 1 3 4 -1 0 0 0
0 0 0 -1 4 3 2 4 6 1 3 4 -1 0 0 0
0 0 0 -1 4 3 2 4 6 1 3 4 -1 0 0 0
0 0 0 -1 4 3 2 4 6 1 3 4 -1 0 0 0
0 0 0 -1 -1 -1 -1 -1 -1 -1 -1 -1 -1 0 0 0
0 0 0 0 0 0 0 0 0 0 0 0 0 0 0 0
0 0 0 0 0 0 0 0 0 0 0 0 0 0 0 0
0 0 0 0 0 0 0 0 0 0 0 0 0 0 0 0
0 0 0 0 0 0 0 0 0 0 0 0 0 0 0 0
0 0 0 0 0 0 0 0 0 0 0 0 0 0 0 0
0 0 0 0 0 0 0 0 0 0 0 0 0 0 0 0
0 0 0 0 0 0 0 0 0 0 0 0 0 0 0 0