0 0 0 0 0 0 0 0 0 0 0 0 0 0 0 0
0 0 0 0 0 0 0 0 0 0 0 0 0 0 0 0
0 5 5 5 5 5 5 5 5 5 5 5 5 5 5 0
0 5 0 0 0 0 0 0 0 0 0 0 0 0 5 0
0 5 0 4 4 4 4 4 4 4 4 4 4 0 5 0
0 5 0 4 3 1 2 6 5 1 3 6 4 0 5 0
0 5 0 4 3 1 2 6 5 1 3 6 4 0 5 0
0 5 0 4 3 1 2 6 5 1 3 6 4 0 5 0
0 5 0 4 4 4 4 4 4 4 4 4 4 0 5 0
0 5 0 0 0 0 0 0 0 0 0 0 0 0 5 0
0 5 5 5 5 5 5 5 5 5 5 5 5 5 5 0
0 0 0 0 0 0 0 0 0 0 0 0 0 0 0 0
0 0 0 0 0 0 0 0 0 0 0 0 0 0 0 0
0 0 0 0 0 0 0 0 0 0 0 0 0 0 0 0
0 0 0 0 0 0 0 0 0 0 0 0 0 0 0 0
0 0 0 0 0 0 0 0 0 0 0 0 0 0 0 0